PEB = "countries/People's Empire of Britannia.txt"
PEF = "countries/People's Empire of France.txt"
NDU = "countries/Nordic Union.txt"
IBF = "countries/Iberian Federation.txt"
CRB = "countries/Caribbean Federation.txt"
OTT = "countries/Ottoman Empire.txt"
BTU = "countries/Baltic Union.txt"
TAI = "countries/Taiwan.txt"
ASH = "countries/Austria-Hungary.txt"
AIN = "countries/Ainu.txt"
ZPZ = "countries/Zapadslavia.txt"
EUR = "countries/Eurasia.txt"
CSC = "countries/Crusader States.txt"
UNT = "countries/United Netherlands.txt"
PRK = "countries/People's Republic of Korea.txt"
SHC = "countries/Shanghai Clique.txt"
XIC = "countries/Xian Clique.txt"
HNC = "countries/Hunan Clique.txt"
FJC = "countries/Fujian Clique.txt"
SRA = "countries/Surat.txt"
BEN = "countries/Bengaluru.txt"
WAL = "countries/Walatir.txt"
SKE = "countries/Sikh Empire.txt"
SCC = "countries/Sichuan Clique.txt"
PRU = "countries/Prussia.txt"
LBR	= "countries/Lithuania-Belarussia.txt"
CAK	= "countries/Central Asian Khaganate.txt"
BTE	= "countries/Bantu Empire.txt"
GRA = "countries/Green Armies.txt"
GRU = "countries/Green Ukraine.txt"
KUR = "countries/Kurdistan.txt"
FRT	= "countries/Free Territory.txt"
COR = "countries/Corsica.txt"
FRS	= "countries/Free Sailors.txt"
SWA = "countries/Siberian White Army.txt"
DON = "countries/Don Republic.txt"
KUB = "countries/Kuban Republic.txt"
CWA = "countries/Caucasus White Army.txt"
ISL = "countries/Islamic Army of the Caucasus.txt"
MNR = "countries/Mountain Republic.txt" #wtf